Chorizo (1).bmp	Chorizo
Chorizo (2).bmp	Chorizo
Chorizo (3).bmp	Chorizo
Chorizo (4).bmp	Chorizo
Chorizo (5).bmp	Chorizo
Chorizo (6).bmp	Chorizo
Chorizo (7).bmp	Chorizo
Chorizo (8).bmp	Chorizo
Chorizo (9).bmp	Chorizo
Chorizo (10).bmp	Chorizo
Chorizo (11).bmp	Chorizo
Chorizo (12).bmp	Chorizo
Chorizo (13).bmp	Chorizo
Chorizo (14).bmp	Chorizo
Chorizo (15).bmp	Chorizo
Chorizo (16).bmp	Chorizo
Chorizo (17).bmp	Chorizo
Salami (1).bmp	Salami
Salami (2).bmp	Salami
Salami (3).bmp	Salami
Salami (4).bmp	Salami
Salami (5).bmp	Salami
Salami (6).bmp	Salami
Salami (7).bmp	Salami
Salami (8).bmp	Salami
Salami (9).bmp	Salami
Salami (10).bmp	Salami
Salami (11).bmp	Salami
Salami (12).bmp	Salami
Salami (13).bmp	Salami
Salami (14).bmp	Salami
Salami (15).bmp	Salami
Salami (16).bmp	Salami
Salami (17).bmp	Salami
Pepperoni (1).bmp	Pepperoni
Pepperoni (2).bmp	Pepperoni
Pepperoni (3).bmp	Pepperoni
Pepperoni (4).bmp	Pepperoni
Pepperoni (5).bmp	Pepperoni
Pepperoni (6).bmp	Pepperoni
Pepperoni (7).bmp	Pepperoni
Pepperoni (8).bmp	Pepperoni
Pepperoni (9).bmp	Pepperoni
Pepperoni (10).bmp	Pepperoni
Pepperoni (11).bmp	Pepperoni
Pepperoni (12).bmp	Pepperoni
Pepperoni (13).bmp	Pepperoni
Pepperoni (14).bmp	Pepperoni
Pepperoni (15).bmp	Pepperoni
Pepperoni (16).bmp	Pepperoni
Pepperoni (17).bmp	Pepperoni
